111111111111111
10001001C0000E1
1C0010000000111
100000111000001
100000P10000111
111000000000011
1C00000011100C1
100000000000001
100001111111001
10000000C1C0001
111111111111111